skb= Boltzmann constant
se= Elementary charge
sme= Electron mass
smp= Proton mass
sG= Gravitatiional constant
sh= Plank constant
shbar= 
sc= speed of the light
seph0= Electric permeability
smu0= Magnetic permeability
sry= Rydberg constant
sa0= Bohr radius
scer= Classical electron radius
salpha= Fine_Structure constant
ssb= Stefan_Boltzmann constant
sL0= Wavelength associate with 1 eV
sw0= Frecuency associate with 1 eV
sk0= Wave number associate with 1 eV
sevj= Energy in 1 eV
seRy= Energy in 1 Rydberg
sem= Energy in 1 mยน
seK= Energy in 1 Kelvin
sTev= Temperature in 1 eV
sNa= Avogadro number
sF= Faraday constant
sR= Gas constant
sno= Loschmidt's number
sma= Atomic mass unity
sT0=Standar temperature
sp0= Atmospheric pressure
smmHg= Pressure of 1 mm Hg
sv0= Molar volume at STP
sMair= Molar weight of air
scal= Calorie